Region_group_of_destination,Location code of destination,WORLD,Latin America and the Caribbean,Europe and Northern America,Developed regions,Less developed regions,Less developed regions excluding least developed,Middle-income countries,Upper-middle-income-countries,Lower-middle-income countries,Low-income countries,AFRICA,ASIA,EUROPE,Caribbean,Central America,South America,NORTHERN AMERICA,year
WORLD,900,280598105,42890481,67601621,69815370,198125584,150520987,177395834,87648518,89747316,37419672,40567163,114911484,63273663,9078772,16198974,17612735,4327958,2020
  Sub-Saharan Africa,947,22221538,30679,527437,541895,19257181,4090210,6021306,412419,5608887,13147474,18993545,234293,497863,13685,1051,15943,29574,2020
  Northern Africa and Western Asia,1833,49767746,68381,2772902,2790395,44942830,35578068,33927565,6258527,27669038,11754346,6567141,38312471,2600363,329,3939,64113,172539,2020
  Central and Southern Asia,921,19427576,14684,4590984,4612050,13771372,4974131,13517912,4856366,8661546,4485915,56405,13715893,4507238,56,0,14628,83746,2020
  Eastern and South-Eastern Asia,1832,19591106,333438,518524,710241,17690334,12501179,16468832,8696270,7772562,18199,20577,17442736,212621,145,2962,330331,305903,2020
  Latin America and the Caribbean,1830,14794623,11297173,2648939,2739482,11663420,10763261,10099478,8799078,1300400,905926,48791,402369,1355886,1335731,827876,9133566,1293053,2020
  Oceania (excluding Australia and New Zealand),1835,313069,5094,101312,126045,162851,151564,128897,48703,80194,0,2600,88735,74042,5094,0,0,27270,2020
  Australia and New Zealand,927,9067584,209475,3136402,3902982,5006295,4564617,4470771,2399850,2070921,185156,585073,3961776,2909353,6593,22048,180834,227049,2020
  Europe and Northern America,1829,145414863,30931557,53305121,54392280,85631301,77897957,92761073,56177305,36583768,6922656,14293031,40753211,51116297,7717139,15341098,7873320,2188824,2020
  Developed regions,901,157253443,31401278,56578680,58447543,92975532,84780609,99119662,59748598,39371064,7107812,14885507,46785274,54093598,7723732,15365881,8311665,2485082,2020
  Less developed regions,902,123344662,11489203,11022941,11367827,105150052,65740378,78276172,27899920,50376252,30311860,25681656,68126210,9180065,1355040,833093,9301070,1842876,2020
" Less developed regions, excluding least developed countries",934,107159937,11448272,10839685,11166659,90655513,62366486,73110566,27125684,45984882,21093242,13831063,65514256,9053571,1340417,832125,9275730,1786114,2020
" Less developed regions, excluding China",948,118939005,11421146,10928287,11237195,101082228,61685872,74691542,24895061,49796481,30311860,25681656,64106348,9141989,1355040,833093,9233013,1786298,2020
  Least developed countries,941,16184725,40931,183256,201168,14494539,3373892,5165606,774236,4391370,9218618,11850593,2611954,126494,14623,968,25340,56762,2020
  Land-locked Developing Countries (LLDC),1636,15022720,280364,4788228,4795579,9389885,3435514,8240771,5061205,3179566,5740288,7199642,1914619,4769118,5890,14312,260162,19110,2020
  Small island developing States (SIDS),1637,5678001,1157533,582238,623316,4590872,3682792,3707850,2336183,1371667,642263,168400,3200838,276585,868835,64703,223995,305653,2020
  High-income countries,1503,181897756,33714977,47333917,49284055,125081808,109144784,117946103,59946932,57999171,10493994,18928986,72537027,44341619,8323845,15426093,9965039,2992298,2020
  Middle-income countries,1517,85895533,9015116,19731350,19989655,61373678,38673953,55810379,27051049,28759330,18737963,11198245,41307367,18406391,669410,771913,7573793,1324959,2020
 Upper-middle-income countries,1502,57383443,8774782,14177798,14374719,40962838,31198486,38866884,20596985,18269899,10811121,2895521,29409476,13039726,663344,671416,7440022,1138072,2020
 Lower-middle-income countries,1501,28512090,240334,5553552,5614936,20410840,7475467,16943495,6454064,10489431,7926842,8302724,11897891,5366665,6066,100497,133771,186887,2020
  Low-income countries,1500,12232043,28692,298517,300233,11398965,2589406,3474543,579030,2895513,8121431,10306328,1063461,289706,14616,968,13108,8811,2020
 AFRICA,903,25389464,32524,702018,720067,22154154,5357102,6901516,649240,6252276,14942739,20917565,1207631,648455,13714,2089,16721,53563,2020
  Eastern Africa,910,7682801,57,146097,146771,7114163,439317,831876,66474,765402,6251565,7031623,82784,142162,57,0,0,3935,2020
  Middle Africa,911,3861568,531,65744,65783,2963620,480825,842079,115229,726850,2124029,2957755,5363,62806,531,0,0,2938,2020
  Northern Africa,912,3167926,1845,174581,178172,2896973,1266892,880210,236821,643389,1795265,1924020,973338,150592,29,1038,778,23989,2020
  Southern Africa,913,3125072,13774,272171,285020,2174469,1167498,1500956,171233,1329723,661484,2047496,115225,254975,3442,647,9685,17196,2020
  Western Africa,914,7552097,16317,43425,44321,7004929,2002570,2846395,59483,2786912,4110396,6956671,30921,37920,9655,404,6258,5505,2020
 ASIA,935,85618502,414658,7707829,7934514,73507563,51786486,63034099,19574342,43459757,14463195,4720103,68497762,7169630,501,5863,408294,538199,2020
  Central Asia,5500,5564042,20,4434810,4434917,771614,758942,5034407,4099433,934974,111026,169,771425,4434490,20,0,0,320,2020
  Eastern Asia,906,8975729,331677,341949,425392,8000899,7833182,7068146,5249835,1818311,678,11379,7701062,126271,0,2735,328942,215678,2020
  South-Eastern Asia,920,10615377,1761,176575,284849,9689435,4667997,9400686,3446435,5954251,17521,9198,9741674,86350,145,227,1389,90225,2020
  Southern Asia,5501,13863534,14664,156174,177133,12999758,4215189,8483505,756933,7726572,4374889,56236,12944468,72748,36,0,14628,83426,2020
  Western Asia,922,46599820,66536,2598321,2612223,42045857,34311176,33047355,6021706,27025649,9959081,4643121,37339133,2449771,300,2901,63335,148550,2020
 EUROPE,908,86706068,5395924,45346729,45897927,39470012,35063075,51983186,30361486,21621700,4736532,11024274,23203976,44246425,918445,397416,4080063,1100304,2020
  Eastern Europe,923,20835402,23807,12223867,12235818,8102649,8070611,17752691,10712602,7040089,568517,47212,8037103,12157908,5294,4316,14197,65959,2020
  Northern Europe,924,14973861,589887,7206366,7511623,7236006,5946150,6466266,2912786,3553480,1131617,2030894,4664186,6791001,271966,33792,284129,415365,2020
  Southern Europe,925,17665688,3688480,9009737,9097740,8516191,7492628,11393783,7020324,4373459,522223,2870736,1974188,8793412,443198,273561,2971721,216325,2020
  Western Europe,926,33231117,1093750,16906759,17052746,15615166,13553686,16370446,9715774,6654672,2514175,6075432,8528499,16504104,197987,85747,810016,402655,2020
 LATIN AMERICA AND THE CARIBBEAN,904,14794623,11297173,2648939,2739482,11663420,10763261,10099478,8799078,1300400,905926,48791,402369,1355886,1335731,827876,9133566,1293053,2020
  Caribbean,915,1605148,1050647,420836,422187,1078231,509804,406849,387820,19029,569103,2976,25433,178358,859403,14137,177107,242478,2020
  Central America,916,2302001,1194276,982489,988988,1265667,1258059,1210429,627223,583206,9678,2402,74274,104038,51844,743476,398956,878451,2020
  South America,931,10887474,9052250,1245614,1328307,9319522,8995398,8482200,7784035,698165,327145,43413,302662,1073490,424484,70263,8557503,172124,2020
 NORTHERN AMERICA,905,58708795,25535633,7958392,8494353,46161289,42834882,40777887,25815819,14962068,2186124,3268757,17549235,6869872,6798694,14943682,3793257,1088520,2020
 OCEANIA ,909,9380653,214569,3237714,4029027,5169146,4716181,4599668,2448553,2151115,185156,587673,4050511,2983395,11687,22048,180834,254319,2020
  Australia and New Zealand,927,9067584,209475,3136402,3902982,5006295,4564617,4470771,2399850,2070921,185156,585073,3961776,2909353,6593,22048,180834,227049,2020
  Melanesia,928,124073,0,50770,66338,48635,39289,35761,18735,17026,0,1892,24806,49774,0,0,0,996,2020
  Micronesia,954,118860,5094,22829,25965,85527,84095,68342,7821,60521,0,0,60573,7,5094,0,0,22822,2020
  Polynesia*,957,70136,0,27713,33742,28689,28180,24794,22147,2647,0,708,3356,24261,0,0,0,3452,2020
WORLD,900,247958644,36206000,60592402,62613012,174426790,132944110,157981964,77576140,80405824,31399947,35111959,103378019,56577753,8135307,16291222,11779471,4014649,2015
  Sub-Saharan Africa,947,20721874,28430,478832,491242,17382556,3799692,5621984,386768,5235216,11679184,17119491,235633,452197,13068,989,14373,26635,2015
  Northern Africa and Western Asia,1833,42036092,69539,2299628,2314255,37849384,30609221,29098477,5258274,23840203,9281367,5170960,32612758,2139019,268,3794,65477,160609,2015
  Central and Southern Asia,921,19266265,14978,4462475,4484168,13750467,5368114,13324074,4765935,8558139,4519354,60267,13691148,4375287,59,0,14919,87188,2015
  Eastern and South-Eastern Asia,1832,18027810,293779,458535,632709,16405940,11503421,15231006,8168153,7062853,13782,15761,16193555,189108,143,2359,291277,269427,2015
  Latin America and the Caribbean,1830,9441503,6166726,2473848,2554631,6472006,5844693,5207201,4125774,1081427,636121,39533,341807,1291715,993471,691735,4481520,1182133,2015
  Oceania (excluding Australia and New Zealand),1835,302810,4861,97412,121702,157752,146871,125249,48290,76959,0,2506,85932,71230,4861,0,0,26182,2015
  Australia and New Zealand,927,7769466,159787,2904774,3603595,4034820,3681497,3587529,1952793,1634736,146834,503256,3146091,2714704,6069,19290,134428,190070,2015
  Europe and Northern America,1829,130392824,29467900,47416898,48410710,78373865,71990601,85786444,52870153,32916291,5123305,12200185,37071095,45344493,7117368,15573055,6777477,2072405,2015
  Developed regions,901,140394479,29853910,50440550,52146178,84353343,77602538,90866507,55866217,35000290,5270139,12709831,41929231,48116266,7123437,15594486,7135987,2324284,2015
  Less developed regions,902,107564165,6352090,10151852,10466834,90073447,55341572,67115457,21709923,45405534,26129808,22402128,61448788,8461487,1011870,696736,4643484,1690365,2015
" Less developed regions, excluding least developed countries",934,94124050,6311803,9970201,10267259,78341208,51925772,62616868,20937683,41679185,19002051,12831061,59318619,8337143,997705,695766,4618332,1633058,2015
" Less developed regions, excluding China",948,103368940,6289522,10062583,10343429,86193998,51474774,63684063,18841010,44843053,26129808,22402128,57612844,8425390,1011870,696736,4580916,1637193,2015
  Least developed countries,941,13440115,40287,181651,199575,11732239,3415800,4498589,772240,3726349,7127757,9571067,2130169,124344,14165,970,25152,57307,2015
  Land-locked Developing Countries (LLDC),1636,13821420,250864,4648966,4655635,8284402,3439156,8087499,4913914,3173585,4661418,5951257,2086627,4631683,5164,12907,232793,17283,2015
  Small island developing States (SIDS),1637,5273967,1016688,575191,615548,4202764,3358052,3363293,2181840,1181453,607696,145398,2978559,269953,841699,59937,115052,305238,2015
  High-income countries,1503,158516311,30931523,41263089,43040158,110014482,97045121,104191836,54365728,49826108,7817281,16228156,62993405,38458306,7462258,15643964,7825301,2804783,2015
  Middle-income countries,1517,78597464,5124242,18805532,19044147,54742035,33187885,50202388,22580673,27621715,17340438,10567413,39183636,17606310,590912,646288,3887042,1199222,2015
 Upper-middle-income countries,1502,50991477,4903830,13326418,13505357,35095374,25772378,33812153,16219629,17592524,9664597,2781112,27514704,12309888,585155,549706,3768969,1016530,2015
 Lower-middle-income countries,1501,27605987,220412,5479114,5538790,19646661,7415507,16390235,6361044,10029191,7675841,7786301,11668932,5296422,5757,96582,118073,182692,2015
  Low-income countries,1500,10321749,27722,294854,296472,9435710,2605964,3453305,564849,2888456,6181088,8209844,1197622,286096,14158,970,12594,8758,2015
 AFRICA,903,22860792,29928,628931,644194,19305936,4899633,6385904,592323,5793581,12629038,18200172,1078578,581876,13089,1880,14959,47055,2015
  Eastern Africa,910,6696922,59,137310,137873,6086081,435184,804363,63740,740623,5252175,6012262,74040,133530,59,0,0,3780,2015
  Middle Africa,911,3479911,536,61739,61778,2598931,405224,761626,105640,655986,1839818,2593326,5098,59074,536,0,0,2665,2015
  Northern Africa,912,2138918,1498,150099,152952,1923380,1099941,763920,205555,558365,949854,1080681,842945,129679,21,891,586,20420,2015
  Southern Africa,913,3477903,12016,238534,249554,2152220,1142864,1459480,161492,1297988,682336,2013377,128580,223700,3061,559,8396,14834,2015
  Western Africa,914,7067138,15819,41249,42037,6545324,1816420,2596515,55896,2540619,3904855,6500526,27915,35893,9412,430,5977,5356,2015
 ASIA,935,77191249,376798,7070539,7278180,66082411,46380815,56889637,17986807,38902830,12864649,4166307,61654516,6573735,449,5262,371087,496804,2015
  Central Asia,5500,5392792,22,4300929,4301038,747141,734472,4881551,3977590,903961,107173,174,746945,4300606,22,0,0,323,2015
  Eastern Asia,906,7866663,292094,290678,361768,7135612,7012850,6233725,4845640,1388085,633,8654,6872184,107266,0,2141,289953,183412,2015
  South-Eastern Asia,920,10161147,1685,167857,270941,9270328,4490571,8997281,3322513,5674768,13149,7107,9321371,81842,143,218,1324,86015,2015
  Southern Asia,5501,13873473,14956,161546,183130,13003326,4633642,8442523,788345,7654178,4412181,60093,12944203,74681,37,0,14919,86865,2015
  Western Asia,922,39897174,68041,2149529,2161303,35926004,29509280,28334557,5052719,23281838,8331513,4090279,31769813,2009340,247,2903,64891,140189,2015
 EUROPE,908,74759083,4487571,39390649,39867195,33693430,30222775,46096682,26735133,19361549,3219234,9536606,19797557,38418244,813625,264754,3409192,972405,2015
  Eastern Europe,923,19833989,15579,11341361,11350292,8022841,7986426,17186437,10529120,6657317,588909,33057,7978239,11293059,4564,2207,8808,48302,2015
  Northern Europe,924,13191086,541580,6311494,6583974,6397081,5293968,5873430,2617872,3255558,859279,1742998,4155350,5907202,265394,28321,247865,404292,2015
  Southern Europe,925,15815457,2997487,8621005,8694889,7077708,6282660,9969528,6228956,3740572,346700,2473218,1620565,8433266,372394,165953,2459140,187739,2015
  Western Europe,926,25918551,932925,13116789,13238040,12195800,10659721,13067287,7359185,5708102,1424346,5287333,6043403,12784717,171273,68273,693379,332072,2015
 LATIN AMERICA AND THE CARIBBEAN,904,9441503,6166726,2473848,2554631,6472006,5844693,5207201,4125774,1081427,636121,39533,341807,1291715,993471,691735,4481520,1182133,2015
  Caribbean,915,1501081,940613,420384,421711,966903,423897,323407,304593,18814,543678,2946,24174,175986,832854,15379,92380,244398,2015
  Central America,916,1860215,859613,891348,897199,921607,919405,877813,402179,475634,4055,2208,64562,92826,41860,620056,197697,798522,2015
  South America,931,6080207,4366500,1162116,1235721,4583496,4501391,4005981,3419002,586979,88388,34379,253071,1022903,118757,56300,4191443,139213,2015
 NORTHERN AMERICA,905,55633741,24980329,8026249,8543515,44680435,41767826,39689762,26135020,13554742,1904071,2663579,17273538,6926249,6303743,15308301,3368285,1100000,2015
 OCEANIA ,909,8072276,164648,3002186,3725297,4192572,3828368,3712778,2001083,1711695,146834,505762,3232023,2785934,10930,19290,134428,216252,2015
  Australia and New Zealand,927,7769466,159787,2904774,3603595,4034820,3681497,3587529,1952793,1634736,146834,503256,3146091,2714704,6069,19290,134428,190070,2015
  Melanesia,928,119343,0,47986,63417,47191,38201,35039,18557,16482,0,1787,24471,46991,0,0,0,995,2015
  Micronesia,954,113466,4861,21731,24732,81817,80449,65378,7570,57808,0,0,58076,8,4861,0,0,21723,2015
  Polynesia*,957,70001,0,27695,33553,28744,28221,24832,22163,2669,0,719,3385,24231,0,0,0,3464,2015
WORLD,900,220983187,34637650,58681104,60587161,151638790,116141091,144581899,74175415,70406484,21718616,29193852,88122177,54711301,7273502,16204451,11159697,3969803,2010
  Sub-Saharan Africa,947,15854637,17434,508809,521341,13748957,3021578,4856430,372607,4483823,8822395,13544082,189145,482707,7528,438,9468,26102,2010
  Northern Africa and Western Asia,1833,32638434,67937,2274064,2289696,28547248,22727271,25415582,5800092,19615490,3677421,4373963,24109594,2114469,292,3741,63904,159595,2010
  Central and Southern Asia,921,19676783,14144,4364013,4385378,14384528,5483930,13612014,4692853,8919161,4763288,64628,14321010,4276506,61,0,14083,87507,2010
  Eastern and South-Eastern Asia,1832,15760463,345923,416756,578892,14373649,10208138,13195648,7303444,5892204,12550,15293,14102627,175355,223,2171,343529,241401,2010
  Latin America and the Caribbean,1830,8326588,5344184,2346204,2415773,5592580,5184764,4612680,3672884,939796,418956,27847,285869,1147896,781155,635043,3927986,1198308,2010
  Oceania (excluding Australia and New Zealand),1835,298175,4933,89303,113822,157872,145626,128840,48238,80602,0,3077,88083,63093,4933,0,0,26210,2010
  Australia and New Zealand,927,6830423,127221,2845434,3476542,3248117,2986111,2889873,1628116,1261757,107172,432291,2487507,2685910,5229,16550,105442,159524,2010
  Europe and Northern America,1829,121597684,28715874,45836521,46805717,71585839,66383673,79870832,50657181,29213651,3916834,10732671,32538342,43765365,6474081,15546508,6695285,2071156,2010
  Developed regions,901,130562258,29133420,48795169,50408479,76772235,71295205,84138297,53349971,30788326,4024006,11171167,36667598,46503827,6479310,15565014,7089096,2291342,2010
  Less developed regions,902,90420929,5504230,9885935,10178682,74866555,44845886,60443602,20825444,39618158,17694610,18022685,51454579,8207474,794192,639437,4070601,1678461,2010
" Less developed regions, excluding least developed countries",934,79989053,5473621,9711388,9987056,65939422,41871676,56265436,20084868,36180568,13040289,11044991,49526084,8087603,785179,638919,4049523,1623785,2010
" Less developed regions, excluding China",948,86472612,5453507,9804385,10065169,71189053,41180283,57145639,18059543,39086096,17694610,18022685,47809962,8173719,794192,639437,4019878,1630666,2010
  Least developed countries,941,10431876,30609,174547,191626,8927133,2974210,4178166,740576,3437590,4654321,6977694,1928495,119871,9013,518,21078,54676,2010
  Land-locked Developing Countries (LLDC),1636,11597176,238161,4561135,4567234,6219200,3087765,7715284,4854975,2860309,2891256,4055698,1929448,4544987,4311,11344,222506,16148,2010
  Small island developing States (SIDS),1637,4710457,838899,582880,621650,3677756,3029889,3027560,1951311,1076249,436581,136938,2642524,252344,672646,53301,112952,330536,2010
  High-income countries,1503,142642749,29967194,39850247,41534023,96287330,85915868,92224331,50617461,41606870,5974273,14003323,52518689,37089395,6771383,15608208,7587603,2760852,2010
  Middle-income countries,1517,69069732,4536897,18313997,18531567,47444345,27093553,48291599,22037481,26254118,11732461,9230759,33791090,17115535,427246,595725,3513926,1198462,2010
 Upper-middle-income countries,1502,42080101,4344135,12778504,12937382,27984748,19663589,31477521,15664201,15813320,4580350,2389052,21338130,11758830,422250,511080,3410805,1019674,2010
 Lower-middle-income countries,1501,26989631,192762,5535493,5594185,19459597,7429964,16814078,6373280,10440798,7152111,6841707,12452960,5356705,4996,84645,103121,178788,2010
  Low-income countries,1500,8781206,18475,297331,298769,7690045,3031905,3944485,1461181,2483304,3955800,5862555,1809546,288735,8926,518,9031,8596,2010
 AFRICA,903,17806677,19077,650710,666414,15483630,3963521,5582171,565473,5016698,9637542,14571247,896987,604211,7558,1340,10179,46499,2010
  Eastern Africa,910,4743657,55,132003,132603,4229845,437268,809235,63831,745404,3392094,4173175,56905,128168,55,0,0,3835,2010
  Middle Africa,911,2436802,403,52964,52998,1877729,282807,673050,77797,595253,1206629,1873615,3732,50639,403,0,0,2325,2010
  Northern Africa,912,1952040,1643,141901,145073,1734673,941943,725741,192866,532875,815147,1027165,707842,121504,30,902,711,20397,2010
  Southern Africa,913,2352541,9765,286219,297482,1833830,782200,1136295,196538,939757,689385,1718813,106637,271293,2667,435,6663,14926,2010
  Western Africa,914,6321637,7211,37623,38258,5807553,1519303,2237850,34441,2203409,3534287,5778479,21871,32607,4403,3,2805,5016,2010
 ASIA,935,66123640,426361,6912932,7108893,55570752,37477396,51497503,17603523,33893980,7638112,3426719,51825389,6444826,546,5010,420805,468106,2010
  Central Asia,5500,5264938,23,4203436,4203547,728074,715076,4766960,3889918,877042,105783,179,727872,4203107,23,0,0,329,2010
  Eastern Asia,906,7062527,344048,261441,331206,6459990,6403448,5518914,4430654,1088260,512,8948,6143459,100300,0,1956,342092,161141,2010
  South-Eastern Asia,920,8697936,1875,155315,247686,7913659,3804690,7676734,2872790,4803944,12038,6345,7959168,75055,223,215,1437,80260,2010
  Southern Asia,5501,14411845,14121,160577,181831,13656454,4768854,8845054,802935,8042119,4657505,64449,13593138,73399,38,0,14083,87178,2010
  Western Asia,922,30686394,66294,2132163,2144623,26812575,21785328,24689841,5607226,19082615,2862274,3346798,23401752,1992965,262,2839,63193,139198,2010
 EUROPE,908,70627160,4581301,37605309,38048407,31497030,28616564,44487704,26403877,18083827,2375394,8748280,18287405,36683624,731903,223182,3626216,921685,2010
  Eastern Europe,923,19110686,12679,10892770,10901008,7825789,7801518,16706486,10406331,6300155,537023,27974,7788892,10848021,4195,1665,6819,44749,2010
  Northern Europe,924,11294937,493859,5436415,5682859,5394117,4534325,5248990,2411977,2837013,545049,1504143,3432605,5057585,253482,23757,216620,378830,2010
  Southern Europe,925,16206273,3208746,8815681,8888897,7267732,6532541,10176571,6418276,3758295,315624,2510638,1563275,8629868,320388,136596,2751762,185813,2010
  Western Europe,926,24015264,866017,12460443,12575643,11009392,9748180,12355657,7167293,5188364,977698,4705525,5502633,12148150,153838,61164,651015,312293,2010
 LATIN AMERICA AND THE CARIBBEAN,904,8326588,5344184,2346204,2415773,5592580,5184764,4612680,3672884,939796,418956,27847,285869,1147896,781155,635043,3927986,1198308,2010
  Caribbean,915,1338893,771209,441216,442477,794532,418693,320760,302312,18448,376473,2847,21269,167866,663895,15516,91798,273350,2010
  Central America,916,1751028,780384,891597,896509,834456,832018,793397,345812,447585,2559,2120,55863,85448,38125,572815,169444,806149,2010
  South America,931,5236667,3792591,1013391,1076787,3963592,3934053,3498523,3024760,473763,39924,22880,208737,894582,79135,46712,3666744,118809,2010
 NORTHERN AMERICA,905,50970524,24134573,8231212,8757310,40088809,37767109,35383128,24253304,11129824,1541440,1984391,14250937,7081741,5742178,15323326,3069069,1149471,2010
 OCEANIA ,909,7128598,132154,2934737,3590364,3405989,3131737,3018713,1676354,1342359,107172,435368,2575590,2749003,10162,16550,105442,185734,2010
  Australia and New Zealand,927,6830423,127221,2845434,3476542,3248117,2986111,2889873,1628116,1261757,107172,432291,2487507,2685910,5229,16550,105442,159524,2010
  Melanesia,928,110691,0,40237,55524,45161,34826,36960,18488,18472,0,2319,24844,39253,0,0,0,984,2010
  Micronesia,954,114743,4933,21670,24717,83518,82224,66701,7408,59293,0,0,59722,9,4933,0,0,21661,2010
  Polynesia*,957,72741,0,27396,33581,29193,28576,25179,22342,2837,0,758,3517,23831,0,0,0,3565,2010
WORLD,900,191446828,29338206,54849090,56551836,127074327,97124428,123912679,65735241,58177438,18605623,25241406,72806043,51336984,6506671,13978650,8852885,3512106,2005
  Sub-Saharan Africa,947,14290369,9240,542868,551191,12664683,2402601,4161144,313149,3847995,8470451,12526389,130458,516257,3004,305,5931,26611,2005
  Northern Africa and Western Asia,1833,23165804,61466,2205508,2218888,19640588,15705483,17598608,4304892,13293716,2670934,3165115,16417905,2070752,259,3311,57896,134756,2005
  Central and Southern Asia,921,18854544,12207,4334189,4351023,13779050,5664215,14050122,4681095,9369027,3753501,39182,13740524,4269185,42,0,12165,65004,2005
  Eastern and South-Eastern Asia,1832,12979157,322635,370029,493317,11641484,8860795,10666977,6379639,4287338,9240,15795,11368396,168844,204,2175,320256,201185,2005
  Latin America and the Caribbean,1830,7184113,4357513,2215736,2297059,4566568,4218434,3665444,2868439,797005,359807,21850,264943,1248692,703194,563563,3090756,967044,2005
  Oceania (excluding Australia and New Zealand),1835,306039,3473,85857,112346,167866,154454,137438,52896,84542,0,2993,96972,58170,3473,0,0,27687,2005
  Australia and New Zealand,927,5717982,99412,2732969,3258707,2367012,2197587,2119760,1271906,847854,73026,324678,1765158,2600184,4679,14529,80204,132785,2005
  Europe and Northern America,1829,108948820,24472260,42361934,43269305,62247076,57920859,71513186,45863225,25649961,3268664,9145404,29021687,40404900,5791816,13394767,5285677,1957034,2005
  Developed regions,901,116678357,24845504,45201687,46647063,66440897,61933127,74932281,48139323,26792958,3341690,9475935,32333969,43054652,5796495,13411141,5637868,2147035,2005
  Less developed regions,902,74768471,4492702,9647403,9904773,60633430,35191301,48980398,17595918,31384480,15263933,15765471,40472074,8282332,710176,567509,3215017,1365071,2005
" Less developed regions, excluding least developed countries",934,64976460,4469946,9483430,9726175,51971019,32464669,45082776,16907141,28175635,10552226,8930708,38659221,8167604,705264,567015,3197667,1315826,2005
" Less developed regions, excluding China",948,71088981,4452548,9572666,9801514,57346314,31914837,45950331,15065386,30884945,15263933,15765471,37209203,8251961,710176,567509,3174863,1320705,2005
  Least developed countries,941,9792011,22756,163973,178598,8662411,2726632,3897622,688777,3208845,4711707,6834763,1812853,114728,4912,494,17350,49245,2005
  Land-locked Developing Countries (LLDC),1636,11576028,232501,4614485,4619610,6157336,3205848,7931602,5167336,2764266,2671117,3696636,2232370,4599270,1368,12094,219039,15215,2005
  Small island developing States (SIDS),1637,3918084,765577,592620,630853,2968147,2453164,2403783,1660179,743604,366420,104239,2037027,242728,609284,51669,104624,349892,2005
  High-income countries,1503,119026154,25524614,35604502,37107907,77294323,69548247,74521097,43448398,31072699,4640985,11358311,40621384,32997057,6062832,13445463,6016319,2607445,2005
  Middle-income countries,1517,64747471,3700019,18736542,18932075,43365853,25463187,46391985,21556593,24835392,10366885,8542201,31226426,17842762,377094,532693,2790232,893780,2005
 Upper-middle-income countries,1502,38209661,3519406,12897045,13048426,24199062,17882973,28737944,14887250,13850694,3941896,1727970,19039539,12147021,373029,452344,2694033,750024,2005
 Lower-middle-income countries,1501,26537810,180613,5839497,5883649,19166791,7580214,17654041,6669343,10984698,6424989,6814231,12186887,5695741,4065,80349,96199,143756,2005
  Low-income countries,1500,7227899,12110,300774,301643,6221335,2022897,2893997,679393,2214604,3548935,5254581,955233,291643,4829,494,6787,9131,2005
 AFRICA,903,16040087,10748,662187,673429,14208097,3299555,4861426,486435,4374991,9137069,13411177,789396,617032,3032,1129,6587,45155,2005
  Eastern Africa,910,4788649,52,129638,130139,4282512,382162,793510,61823,731687,3462827,4235761,47004,126163,52,0,0,3475,2005
  Middle Africa,911,1961951,169,45657,45688,1699546,277030,639049,65115,573934,1061346,1696870,2525,43259,169,0,0,2398,2005
  Northern Africa,912,1749718,1508,119319,122238,1543414,896954,700282,173286,526996,666618,884788,658938,100775,28,824,656,18544,2005
  Southern Africa,913,1582721,7352,326717,334391,1193257,502830,763914,152780,611134,422621,1116543,70353,311920,2255,300,4797,14797,2005
  Western Africa,914,5957048,1667,40856,40973,5489368,1240579,1964671,33431,1931240,3523657,5477215,10576,34915,528,5,1134,5941,2005
 ASIA,935,53249787,394800,6790407,6940990,43517708,29333539,41615425,15192340,26423085,5767057,2335304,40867887,6408006,477,4662,389661,382401,2005
  Central Asia,5500,5235877,24,4209533,4209645,716005,702512,4729185,3916651,812534,136730,182,715799,4209202,24,0,0,331,2005
  Eastern Asia,906,6228684,316553,234387,293386,5554844,5513597,4769923,3849243,920680,271,7326,5261415,90804,0,1845,314708,143583,2005
  South-Eastern Asia,920,6750473,6082,135642,199931,6086640,3347198,5897054,2530396,3366658,8969,8469,6106981,78040,204,330,5548,57602,2005
  Southern Asia,5501,13618667,12183,124656,141378,13063045,4961703,9320937,764444,8556493,3616771,39000,13024725,59983,18,0,12165,64673,2005
  Western Asia,922,21416086,59958,2086189,2096650,18097174,14808529,16898326,4131606,12766720,2004316,2280327,15758967,1969977,231,2487,57240,116212,2005
 EUROPE,908,63585731,3453004,34240566,34638449,27786297,25340525,41249398,24892830,16356568,2036165,7620545,16825888,33415975,590659,154019,2708326,824591,2005
  Eastern Europe,923,19744557,12498,11490371,11497006,7837224,7810299,17363561,10902048,6461513,509859,25516,7801479,11453663,4066,1356,7076,36708,2005
  Northern Europe,924,9588814,457405,4668255,4890252,4491511,3798256,4577459,2260573,2316886,430382,1188599,2879637,4329929,240782,21197,195426,338326,2005
  Southern Europe,925,12004024,2214175,6508233,6568992,5332451,4719735,7717276,5018939,2698337,249797,1986283,1144789,6354161,202899,82080,1929196,154072,2005
  Western Europe,926,22248336,768926,11573707,11682199,10125111,9012235,11591102,6711270,4879832,846127,4420147,4999983,11278222,142912,49386,576628,295485,2005
 LATIN AMERICA AND THE CARIBBEAN,904,7184113,4357513,2215736,2297059,4566568,4218434,3665444,2868439,797005,359807,21850,264943,1248692,703194,563563,3090756,967044,2005
  Caribbean,915,1275731,703367,464604,466362,724147,405644,312122,296341,15781,319011,2634,19476,165537,601238,17444,84685,299067,2005
  Central America,916,1378041,644805,640890,645885,685930,684153,654624,258235,396389,3046,1707,43622,72703,29231,503647,111927,568187,2005
  South America,931,4530341,3009341,1110242,1184812,3156491,3128637,2698698,2313863,384835,37750,17509,201845,1010452,72725,42472,2894144,99790,2005
 NORTHERN AMERICA,905,45363089,21019256,8121368,8630856,34460779,32580334,30263788,20970395,9293393,1232499,1524859,12195799,6988925,5201157,13240748,2577351,1132443,2005
 OCEANIA ,909,6024021,102885,2818826,3371053,2534878,2352041,2257198,1324802,932396,73026,327671,1862130,2658354,8152,14529,80204,160472,2005
  Australia and New Zealand,927,5717982,99412,2732969,3258707,2367012,2197587,2119760,1271906,847854,73026,324678,1765158,2600184,4679,14529,80204,132785,2005
  Melanesia,928,103881,0,35275,52300,42968,32921,33178,14862,18316,0,2192,21294,34073,0,0,0,1202,2005
  Micronesia,954,128390,3473,22335,25937,94972,92324,78429,14891,63538,0,0,72588,11,3473,0,0,22324,2005
  Polynesia*,957,73768,0,28247,34109,29926,29209,25831,23143,2688,0,801,3090,24086,0,0,0,4161,2005
WORLD,900,173230585,24628700,52877703,54458296,111708559,83646070,109879954,59585818,50294136,18002895,22080003,65333613,49727784,5966487,12228703,6433510,3149919,2000
  Sub-Saharan Africa,947,13151229,8183,464730,471455,11724105,1910799,3653833,270088,3383745,8043817,11605959,111194,441396,2893,235,5055,23334,2000
  Northern Africa and Western Asia,1833,20321397,55913,2226917,2238906,16685026,13174508,14697626,3850951,10846675,2595196,3289880,13342843,2103623,230,2899,52784,123294,2000
  Central and Southern Asia,921,20139825,10255,4321012,4333072,15275132,5888306,14875034,4722984,10152050,4483563,6100,15269431,4283297,34,0,10221,37715,2000
  Eastern and South-Eastern Asia,1832,10506212,342745,330879,437089,9184305,7616475,8252645,5369436,2883209,9107,15766,8882781,150990,222,2150,340373,179889,2000
  Latin America and the Caribbean,1830,6539738,3777576,2192784,2286385,3966593,3671473,3113579,2453575,660004,309234,20285,258933,1396387,639148,511753,2626675,796397,2000
  Oceania (excluding Australia and New Zealand),1835,296618,1606,79730,106042,166853,153335,137107,54884,82223,0,2817,97997,51151,1606,0,0,28579,2000
  Australia and New Zealand,927,5065063,87624,2693870,3147363,1833342,1723622,1661962,1004243,657719,40873,226043,1362205,2582983,4269,13770,69585,110887,2000
  Europe and Northern America,1829,97210503,20344798,40567781,41437984,52873203,49507552,63488168,41859657,21628511,2521105,6913153,26008229,38717957,5318085,11697896,3328817,1849824,2000
  Developed regions,901,103962010,20737821,43358192,44694341,56246319,52762010,66057663,43572984,22484679,2561978,7143697,28600308,41342533,5322354,11713406,3702061,2015659,2000
  Less developed regions,902,69268575,3890879,9519511,9763955,55462240,30884060,43822291,16012834,27809457,15440917,14936306,36733305,8385251,644133,515297,2731449,1134260,2000
" Less developed regions, excluding least developed countries",934,59204627,3869885,9369276,9600886,46407852,28410431,39913558,15399929,24513629,10339894,7754980,34875125,8279828,639292,514776,2715817,1089448,2000
" Less developed regions, excluding China",948,65850628,3863103,9452757,9672312,52566025,27997190,41077833,13733859,27343974,15440917,14936306,33850994,8358771,644133,515297,2703673,1093986,2000
  Least developed countries,941,10063948,20994,150235,163069,9054388,2473629,3908733,612905,3295828,5101023,7181326,1858180,105423,4841,521,15632,44812,2000
  Land-locked Developing Countries (LLDC),1636,11503826,231275,4713692,4718563,6019679,3226758,8186466,5439397,2747069,2381786,3394828,2397768,4699742,1013,12826,217436,13950,2000
  Small island developing States (SIDS),1637,3287168,700455,586941,623030,2420817,2019730,1923932,1440040,483892,309108,83724,1576018,242505,546700,49456,104299,344436,2000
  High-income countries,1503,101641715,21281197,32896823,34286380,63574683,57520455,61605235,37343770,24261465,3605879,8703335,33823114,30444071,5563828,11742187,3975182,2452752,2000
  Middle-income countries,1517,63873275,3247925,19476932,19664331,41990378,24599410,45824987,21861498,23963489,10500918,7893888,30950682,18792072,340109,485995,2421821,684860,2000
 Upper-middle-income countries,1502,35822210,3083977,13082508,13229930,21632390,16888112,26911162,14702672,12208490,3587583,1655720,16982234,12518007,336459,411741,2335777,564501,2000
 Lower-middle-income countries,1501,28051065,163948,6394424,6434401,20357988,7711298,18913825,7158826,11754999,6913335,6238168,13968448,6274065,3650,74254,86044,120359,2000
  Low-income countries,1500,7322731,11916,313976,314825,5983743,1446625,2366651,338231,2028420,3855948,5415746,556670,303210,4766,521,6629,10766,2000
 AFRICA,903,15051677,9501,573820,583091,13441582,2749969,4266229,429925,3836304,8940988,12753079,681816,533653,2917,965,5619,40167,2000
  Eastern Africa,910,4847119,50,118980,119445,4394033,334668,855534,57050,798484,3517115,4354686,39628,115836,50,0,0,3144,2000
  Middle Africa,911,1775284,266,53746,53778,1487714,277609,703797,57826,645971,785286,1484711,2753,52117,266,0,0,1629,2000
  Northern Africa,912,1900448,1318,109090,111636,1717477,839170,612396,159837,452559,897171,1147120,570622,92257,24,730,564,16833,2000
  Southern Africa,913,1267695,6552,256558,262692,931628,395125,613504,132880,480624,312996,870591,55294,245022,2348,229,3975,11536,2000
  Western Africa,914,5261131,1315,35446,35540,4910730,903397,1480998,22332,1458666,3428420,4895971,13519,28421,229,6,1080,7025,2000
 ASIA,935,49066986,407595,6769718,6897431,39426986,25840119,37212909,13783534,23429375,6190695,2164626,36924433,6445653,462,4319,402814,324065,2000
  Central Asia,5500,5189082,26,4235932,4236049,666778,647823,4708175,3967180,740995,134652,191,666561,4235587,26,0,0,345,2000
  Eastern Asia,906,5393004,335310,204841,260777,4648790,4618105,3866103,3136913,729190,62,5291,4338120,79133,0,1740,333570,125708,2000
  South-Eastern Asia,920,5113208,7435,126038,176312,4535515,2998370,4386542,2232523,2154019,9045,10475,4544661,71857,222,410,6803,54181,2000
  Southern Asia,5501,14950743,10229,85080,97023,14608354,5240483,10166859,755804,9411055,4348911,5909,14602870,47710,8,0,10221,37370,2000
  Western Asia,922,18420949,54595,2117827,2127270,14967549,12335338,14085230,3691114,10394116,1698025,2142760,12772221,2011366,206,2169,52220,106461,2000
 EUROPE,908,56858793,1699981,32326906,32700393,22925094,21064593,37383312,23474747,13908565,1554885,5797189,15541563,31590963,441759,102356,1155866,735943,2000
  Eastern Europe,923,20435785,12162,12224692,12229655,7739278,7714376,18063137,11506707,6556430,467564,22826,7705038,12195441,3858,1032,7272,29251,2000
  Northern Europe,924,7900973,410637,3875128,4091041,3598475,3076799,3820889,1983530,1837359,302469,928815,2295200,3564201,244318,16753,149566,310927,2000
  Southern Europe,925,7681658,718500,4619133,4668731,2798405,2343568,4786022,3245314,1540708,181213,1370522,719751,4497622,117839,44113,556548,121511,2000
  Western Europe,926,20840377,558682,11607953,11710966,8788936,7929850,10713264,6739196,3974068,603639,3475026,4821574,11333699,75744,40458,442480,274254,2000
 LATIN AMERICA AND THE CARIBBEAN,904,6539738,3777576,2192784,2286385,3966593,3671473,3113579,2453575,660004,309234,20285,258933,1396387,639148,511753,2626675,796397,2000
  Caribbean,915,1216872,647814,474449,476842,668261,399362,307768,293553,14215,269270,2607,19826,174206,540565,18786,88463,300243,2000
  Central America,916,1107577,568796,479845,485751,605955,604678,568911,222949,345962,3909,1425,40907,76055,29325,450936,88535,403790,2000
  South America,931,4215289,2560966,1238490,1323792,2692377,2667433,2236900,1937073,299827,36055,16253,198200,1146126,69258,42031,2449677,92364,2000
 NORTHERN AMERICA,905,40351710,18644817,8240875,8737591,29948109,28442959,26104856,18384910,7719946,966220,1115964,10466666,7126994,4876326,11595540,2172951,1113881,2000
 OCEANIA ,909,5361681,89230,2773600,3253405,2000195,1876957,1799069,1059127,739942,40873,228860,1460202,2634134,5875,13770,69585,139466,2000
  Australia and New Zealand,927,5065063,87624,2693870,3147363,1833342,1723622,1661962,1004243,657719,40873,226043,1362205,2582983,4269,13770,69585,110887,2000
  Melanesia,928,95281,0,29890,46693,41119,31107,29778,11659,18119,0,2055,17709,28637,0,0,0,1253,2000
  Micronesia,954,130186,1606,22666,26567,95888,93099,81261,19544,61717,0,0,77720,13,1606,0,0,22653,2000
  Polynesia*,957,71151,0,27174,32782,29846,29129,26068,23681,2387,0,762,2568,22501,0,0,0,4673,2000
WORLD,900,161289976,19669704,51582164,52993691,100818788,72701450,98929758,53059271,45870487,18959483,22341394,59147922,48636003,5035853,9288464,5345387,2946161,1995
  Sub-Saharan Africa,947,14275437,7946,421399,428086,12911648,1673466,3202066,220369,2981697,9687644,12813616,91221,398770,2836,249,4861,22629,1995
  Northern Africa and Western Asia,1833,18912064,51498,2287605,2301041,15217292,11709314,13202142,3785994,9416148,2720357,3293685,11877220,2166088,151,2583,48764,121517,1995
  Central and Southern Asia,921,21247814,5420,4903088,4915851,15683570,6463982,16231909,5235992,10995917,4111175,10718,15676606,4863593,33,0,5387,39495,1995
  Eastern and South-Eastern Asia,1832,8339806,236277,247149,333206,7221922,6216481,6317966,4308173,2009793,4662,15226,7019460,105929,114,1336,234827,141220,1995
  Latin America and the Caribbean,1830,6661553,3670383,2289656,2390150,3851171,3584665,3007796,2246662,761134,282538,19478,258892,1600698,579841,680929,2409613,688958,1995
  Oceania (excluding Australia and New Zealand),1835,280580,1327,80022,109870,148533,135652,120587,46432,74155,0,2528,86641,47299,1327,0,0,32723,1995
  Australia and New Zealand,927,4741947,86585,2707003,3101960,1578706,1483754,1428643,831307,597336,28273,179490,1180338,2604914,3527,12746,70312,102089,1995
  Europe and Northern America,1829,86830775,15610268,38646242,39413527,44205946,41434136,55418649,36384342,19034307,2124834,6006653,22957544,36848712,4448024,8590621,2571623,1797530,1995
  Developed regions,901,92935093,15916691,41436153,42606608,47033770,44160544,57436480,37697496,19738984,2153107,6189244,25164061,39485417,4451551,8604622,2860518,1950736,1995
  Less developed regions,902,68354883,3753013,10146011,10387083,53785018,28540906,41493278,15361775,26131503,16806376,16152150,33983861,9150586,584302,683842,2484869,995425,1995
" Less developed regions, excluding least developed countries",934,56673106,3736125,10008770,10237641,43037176,26278038,37930318,14799626,23130692,9655866,7153981,32245592,9055820,579109,683292,2473724,952950,1995
" Less developed regions, excluding China",948,65243958,3739047,10089613,10308777,51093664,25857721,38940358,13243578,25696780,16806376,16152150,31294159,9125059,584302,683842,2470903,964554,1995
  Least developed countries,941,11681777,16888,137241,149442,10747842,2262868,3562960,562149,3000811,7150510,8998169,1738269,94766,5193,550,11145,42475,1995
  Land-locked Developing Countries (LLDC),1636,12370057,230812,5409672,5414526,6107149,3162522,8725127,6017301,2707826,2606368,3479895,2400703,5397176,772,12907,217133,12496,1995
  Small island developing States (SIDS),1637,2758806,628371,560267,598126,1862593,1500946,1425553,1029902,395651,280553,86595,1092979,223072,494330,45355,88686,337195,1995
  High-income countries,1503,87896678,16374656,30500368,31711604,52437997,47235694,50674187,30116162,20558025,3071065,7625829,28667067,28144425,4663118,8630101,3081437,2355943,1995
  Middle-income countries,1517,64071357,3199409,20571507,20768329,40655557,24142633,46053899,22521279,23532620,10111059,7547948,30020059,19992803,312039,657813,2229557,578704,1995
 Upper-middle-income countries,1502,35213683,2930933,13209341,13364831,20484053,15896778,25443867,14507412,10936455,4056530,1469536,16184490,12741817,309025,460377,2161531,467524,1995
 Lower-middle-income countries,1501,28857674,268476,7362166,7403498,20171504,8245855,20610032,8013867,12596165,6054529,6078412,13835569,7250986,3014,197436,68026,111180,1995
  Low-income countries,1500,8995692,11845,356500,357243,7596522,1251601,2136622,380704,1755918,5743487,7127106,458054,346361,5131,550,6164,10139,1995
 AFRICA,903,16357077,9417,586122,597864,14752584,2415638,3742040,357608,3384432,10803622,14179992,567843,539020,2860,949,5608,47102,1995
  Eastern Africa,910,4977644,162,94028,94383,4510297,310159,737162,48877,688285,3756961,4482416,27934,91511,162,0,0,2517,1995
  Middle Africa,911,2662490,190,49741,49767,2417060,254119,602785,46293,556492,1815287,2414771,2112,48495,190,0,0,1246,1995
  Northern Africa,912,2081640,1471,164723,169778,1840936,742172,539974,137239,402735,1115978,1366376,476622,140250,24,700,747,24473,1995
  Southern Africa,913,1201708,6213,240121,246340,887023,302967,492992,102515,390477,388775,834340,47307,228301,2292,244,3677,11820,1995
  Western Africa,914,5433595,1381,37509,37596,5097268,806221,1369127,22684,1346443,3726621,5082089,13868,30463,192,5,1184,7046,1995
 ASIA,935,46418044,291724,7273119,7380320,36281848,23647605,35212043,13192920,22019123,5720216,1953253,34096664,6995360,274,3219,288231,277759,1995
  Central Asia,5500,5904795,30,4822654,4822789,674272,658753,5313561,4461911,851650,100650,221,674021,4822254,30,0,0,400,1995
  Eastern Asia,906,4639749,235157,165707,206148,4060324,4039970,3260671,2688182,572489,56,3441,3843056,64669,0,1255,233902,101038,1995
  South-Eastern Asia,920,3700057,1120,81442,127058,3161598,2176511,3057295,1619991,1437304,4606,11785,3176404,41260,114,81,925,40182,1995
  Southern Asia,5501,15343019,5390,80434,93062,15009298,5805229,10918348,774081,10144267,4010525,10497,15002585,41339,3,0,5387,39095,1995
  Western Asia,922,16830424,50027,2122882,2131263,13376356,10967142,12662168,3648755,9013413,1604379,1927309,11400598,2025838,127,1883,48017,97044,1995
 EUROPE,908,53489827,1340812,30731851,31061370,21081523,19481893,35549368,22461500,13087868,1400090,5179831,14667430,29988843,356491,78809,905512,743008,1995
  Eastern Europe,923,21344124,11743,13035105,13039683,7819842,7790402,18960666,12381370,6579296,500661,23051,7785440,13007262,3877,874,6992,27843,1995
  Northern Europe,924,7194824,349688,3860460,4041679,2988210,2583493,3518068,1921055,1597013,221690,730256,1941469,3540898,214725,12237,122726,319562,1995
  Southern Europe,925,6230114,484471,3685402,3735261,2139884,1754412,3663400,2490669,1172731,151798,1077432,590532,3546099,72539,29076,382856,139303,1995
  Western Europe,926,18720765,494910,10150884,10244747,8133587,7353586,9407234,5668406,3738828,525941,3349092,4349989,9894584,65350,36622,392938,256300,1995
 LATIN AMERICA AND THE CARIBBEAN,904,6661553,3670383,2289656,2390150,3851171,3584665,3007796,2246662,761134,282538,19478,258892,1600698,579841,680929,2409613,688958,1995
  Caribbean,915,1121563,583063,448158,450275,600775,357863,275603,262642,12961,243131,2240,17283,158593,489402,17457,76204,289565,1995
  Central America,916,1298916,715741,382397,387295,746314,745193,706038,211445,494593,2830,1281,33622,69859,23127,622093,70521,312538,1995
  South America,931,4241074,2371579,1459101,1552580,2504082,2481609,2026155,1772575,253580,36577,15957,207987,1372246,67312,41379,2262888,86855,1995
 NORTHERN AMERICA,905,33340948,14269456,7914391,8352157,23124423,21952243,19869281,13922842,5946439,724744,826822,8290114,6859869,4091533,8511812,1666111,1054522,1995
 OCEANIA ,909,5022527,87912,2787025,3211830,1727239,1619406,1549230,877739,671491,28273,182018,1266979,2652213,4854,12746,70312,134812,1995
  Australia and New Zealand,927,4741947,86585,2707003,3101960,1578706,1483754,1428643,831307,597336,28273,179490,1180338,2604914,3527,12746,70312,102089,1995
  Melanesia,928,96828,0,27920,49080,40454,30858,30373,12321,18052,0,1820,18832,26283,0,0,0,1637,1995
  Micronesia,954,118687,1327,26594,30280,81227,78561,66812,12719,54093,0,0,65671,18,1327,0,0,26576,1995
  Polynesia*,957,65065,0,25508,30510,26852,26233,23402,21392,2010,0,708,2138,20998,0,0,0,4510,1995
WORLD,900,152986157,15273399,50532413,51826246,92519577,62696205,88958999,46251718,42707281,21142448,20621464,56957000,47730278,4139775,6823036,4310588,2802135,1990
  Sub-Saharan Africa,947,13286341,8497,451346,459671,11835246,1486015,3114727,200693,2914034,8703001,11741856,86266,426230,2864,337,5296,25116,1990
  Northern Africa and Western Asia,1833,17608769,44460,2377910,2392857,13933638,10290728,11805106,3563305,8241801,2966108,3434951,10460973,2259563,86,2197,42177,118347,1990
  Central and Southern Asia,921,26168623,589,5515044,5528522,19705482,7003855,17512955,5672330,11840625,7459273,15361,19697225,5473732,37,0,552,41312,1990
  Eastern and South-Eastern Asia,1832,6835882,75239,208066,286149,5775335,5191700,4870344,3485669,1384675,5060,16924,5729543,95531,102,847,74290,112535,1990
  Latin America and the Caribbean,1830,7135971,3980808,2419971,2528120,4157670,3918912,3314634,2061127,1253507,256604,19192,263267,1817209,523950,1253201,2203657,602762,1990
  Oceania (excluding Australia and New Zealand),1835,258678,1117,78727,107527,130525,118368,104084,38847,65237,0,2216,75767,42359,1117,0,0,36368,1990
  Australia and New Zealand,927,4473260,81984,2699258,3069242,1378725,1301107,1248207,726691,521516,15817,159742,1008125,2603009,2804,11005,68175,96249,1990
  Europe and Northern America,1829,77218633,11080705,36782091,37454158,35602956,33385520,46988942,30503056,16485886,1736585,5231222,19635834,35012645,3608815,5555449,1916441,1769446,1990
  Developed regions,901,82767210,11232859,39549470,40596772,37973694,35675359,48540576,31467011,17073565,1752402,5392123,21564643,37640490,3611619,5567240,2054000,1908980,1990
  Less developed regions,902,70218947,4040540,10982943,11229474,54545883,27020846,40418423,14784707,25633716,19390046,15229341,35392357,10089788,528156,1255796,2256588,893155,1990
" Less developed regions, excluding least developed countries",934,59158726,4028050,10861681,11096531,44341114,25142254,37207346,14279128,22928218,12419089,6442344,33982015,10008718,522711,1255216,2250123,852963,1990
" Less developed regions, excluding China",948,67419066,4036926,10939633,11167300,52059743,24541727,38051935,12826383,25225552,19390046,15229341,32899176,10067729,528156,1255796,2252974,871904,1990
  Least developed countries,941,11060221,12490,121262,132943,10204769,1878592,3211077,505579,2705498,6970957,8786997,1410342,81070,5445,580,6465,40192,1990
  Land-locked Developing Countries (LLDC),1636,14212843,229130,6210950,6215934,7046943,2807534,9008463,6526929,2481534,4037108,4776285,2045970,6199168,567,12870,215693,11782,1990
  Small island developing States (SIDS),1637,2312665,558153,535559,571072,1365300,1061009,982999,687774,295225,252573,69809,688903,203598,441417,41653,75083,331961,1990
  High-income countries,1503,76295202,11606947,28493395,29572905,42021535,37589556,40194118,22857458,17336660,2586544,6747963,23874694,26203905,3792515,5590653,2223779,2289490,1990
  Middle-income countries,1517,67228996,3574943,21492661,21703542,42556857,23980957,46609443,22913814,23695629,12436995,6442942,32664148,20991096,288516,1231803,2054624,501565,1990
 Upper-middle-income countries,1502,35289343,3179940,12996117,13166671,20660526,15137113,24210955,14002288,10208667,5322475,1366488,16230666,12605008,285515,895249,1999176,391109,1990
 Lower-middle-income countries,1501,31939653,395003,8496544,8536871,21896331,8843844,22398488,8911526,13486962,7114520,5076454,16433482,8386088,3001,336554,55448,110456,1990
  Low-income countries,1500,9193274,11565,425569,426343,7835868,1061803,2102186,440527,1661659,6090345,7408983,415823,415675,5397,580,5588,9894,1990
 AFRICA,903,15689666,10188,680256,696330,13926799,2153279,3603629,319979,3283650,10143177,13431488,492107,622122,2889,1033,6266,58134,1990
  Eastern Africa,910,5959183,164,80302,80687,5513724,237772,574053,36536,537517,4929324,5493292,20505,77968,164,0,0,2334,1990
  Middle Africa,911,1461155,164,46538,46557,1237101,233616,754117,35627,718490,483867,1235281,1666,45733,164,0,0,805,1990
  Northern Africa,912,2403325,1691,228910,236659,2091553,667264,488902,119286,369616,1440176,1689632,405841,195892,25,696,970,33018,1990
  Southern Africa,913,1395265,6935,286997,294835,978550,294198,527552,106122,421430,444220,922363,50312,271865,2386,333,4216,15132,1990
  Western Africa,914,4470738,1234,37509,37592,4105871,720429,1259005,22408,1236597,2845590,4090920,13783,30664,150,4,1080,6845,1990
 ASIA,935,48209949,118597,7872110,7970869,37322902,21819019,33699503,12602018,21097485,8990265,1777604,35481900,7632934,200,2348,116049,239176,1990
  Central Asia,5500,6630683,37,5439295,5439461,671884,663003,5959668,4986035,973633,47239,273,671574,5438801,37,0,0,494,1990
  Eastern Asia,906,3959266,74357,129673,158990,3532915,3521776,2721222,2242244,478978,51,1159,3472803,51817,0,786,73571,77856,1990
  South-Eastern Asia,920,2876616,882,78393,127159,2242420,1669924,2149122,1243425,905697,5009,15765,2256740,43714,102,61,719,34679,1990
  Southern Asia,5501,19537940,552,75749,89061,19033598,6340852,11553287,686295,10866992,7412034,15088,19025651,34931,0,0,552,40818,1990
  Western Asia,922,15205444,42769,2149000,2156198,11842085,9623464,11316204,3444019,7872185,1525932,1745319,10055132,2063671,61,1501,41207,85329,1990
 EUROPE,908,49608225,1104536,29136831,29428587,19140735,17772590,33197699,20935850,12261849,1246003,4682594,13453956,28367362,297313,63442,743781,769469,1990
  Eastern Europe,923,21995312,11129,13810324,13814527,7670534,7637228,19600284,13145953,6454331,518476,22975,7636513,13783392,3802,717,6610,26932,1990
  Northern Europe,924,6645605,290476,3967820,4118305,2416827,2123448,3258582,1862502,1396080,142437,546557,1610470,3629383,188868,7648,93960,338437,1990
  Southern Europe,925,4340433,365575,2423277,2475159,1736155,1394577,2357047,1445912,911135,137895,894648,490981,2257843,49533,22406,293636,165434,1990
  Western Europe,926,16626875,437356,8935410,9020596,7317219,6617337,7981786,4481483,3500303,447195,3218414,3715992,8696744,55110,32671,349575,238666,1990
 LATIN AMERICA AND THE CARIBBEAN,904,7135971,3980808,2419971,2528120,4157670,3918912,3314634,2061127,1253507,256604,19192,263267,1817209,523950,1253201,2203657,602762,1990
  Caribbean,915,1031083,519266,426110,427979,534534,317031,244024,231905,12119,217573,1943,14968,144291,437177,16519,65570,281819,1990
  Central America,916,1829911,1277036,308402,312608,1303921,1302712,1253628,220404,1033224,2000,1423,29212,69985,20425,1195652,60959,238417,1990
  South America,931,4274977,2184506,1685459,1787533,2319215,2299169,1816982,1608818,208164,37031,15826,219087,1602933,66348,41030,2077128,82526,1990
 NORTHERN AMERICA,905,27610408,9976169,7645260,8025571,16462221,15612930,13791243,9567206,4224037,490582,548628,6181878,6645283,3311502,5492007,1172660,999977,1990
 OCEANIA ,909,4731938,83101,2777985,3176769,1509250,1419475,1352291,765538,586753,15817,161958,1083892,2645368,3921,11005,68175,132617,1990
  Australia and New Zealand,927,4473260,81984,2699258,3069242,1378725,1301107,1248207,726691,521516,15817,159742,1008125,2603009,2804,11005,68175,96249,1990
  Melanesia,928,91200,0,24906,45664,38895,29876,30134,13050,17084,0,1576,19231,23303,0,0,0,1603,1990
  Micronesia,954,108969,1117,30441,34086,67780,65180,53228,6707,46521,0,0,54838,23,1117,0,0,30418,1990
  Polynesia*,957,58509,0,23380,27777,23850,23312,20722,19090,1632,0,640,1698,19033,0,0,0,4347,1990
